0000000000000000000
0111111110111111110
0100100010100010010
0111111111111111110
0100101000001010010
0211101110111011120
0000100010100010000
9990101111111010999
0000101001001010000
1111111011101111111
0000101000001010000
9990101111111010999
0000101000001010000
0211111110111111120
0100100010100010010
0110111111111110110
0010101000001010100
0111101110111011110
0100000010100000010
0911111111111111110
0000000000000000000
1 19
1 1
1 3
17 1
17 3